1 13 31
###############################
#p     s* *   *    *  * * *  2#
# # # #b# # #*#*# # # #*#*#*# #
#  x      *           *   * * #
# # # # # #*# # #*#*# # # # #*#
#f        x **  *  *    3     #
# # # # # # # # # #*# # # # # #
#* 111111111111111            #
# # # # #*# # # #*#*# # # # # #
#*   **  *        1           #
# #*# # # # # # #*# # # # # # #
#           *   *  *          #
###############################